../sprites/Background.bmp
60 25
110000000000000000000000000000000000000000000000000000000000
100000000000000000000000000000000000000000000000000000000000
100000000000000000000000000000000000000000000000000000000000
100000000000000000000000000000000000000000000000000000000000
100000020202004230200000000000000000000000000000000000000000
100000011100000100123042043042000000000000000000000000000000
100000010102000100101061010061000000000000000000000000000000
100000000000000000000000000000000000000000000000000000000000
100000000000000000000000000000000000000000000000000000000000
100000000000000000000000000000000000000000000000000000000000
100000000000000000000000000000000000000000000000000000000000
100000000000042222222230000000000000000000000000000000000000
110000000000061111111150000000000000000000000000000000000000
101000000000000000000000000000000000000000000000000000000000
100100000000000000000000000000000000000000000000000000000000
100010000000000000000000000000000000010000000000000000000000
100001000000000000000000000000000000011100000000000000000000
100000100000000000000000000000000000000000000000000000000000
100000010000000000000000000000000000000000000000000000000000
100000001000000000000000000000000000000000000000000000000000
122222300100000000000000000000200000000000000000000000000000
111111100010000000000000000000000000000000000000000000000000
111111122301000000000000000000200000000000000000000000000000
111111111122222222222222222222122222222222222222222222222222
111111111111111111111111111111111111111111111111111111111111
