../sprites/Background.bmp
60 25
110000000000000000000000000000000000000000000000000000000000
100000000000000000000000000000000000000000000000000000000000
100000000000000000000000000000000000000000000000000000000000
100000000000000000000000000000000000000000000000000000000000
100000020202004230200000000000000000000000000000000000000000
100000011100000100123042043042000000000000000000000000000000
100000010102000100101061010061000000000000000000000000000000
100000000000000000000000000000000000000000000000000000000000
100000000000000000000000000000000000000000000000000000000000
100000000000000000000000000000000000000000000000000000000000
100000000000000000000000000000000000000000000000000000000000
100000000000042222222230000000000000000000000000000000000000
100000000000061111111150000000000000000000000000000000000000
100000000000000000000000000000000000000000000000000000000000
100000000000000000000000000000000000000000000000000000000000
100000000000000000000000000000000000010000000000000000000000
100000000000000000000000000000000000011100000000000000000000
100000000000000000000000000000000000000000000000000000000000
100000000000000000000000000000000000000000000000000000000000
100000000000000000000000000000000000000000000000000000000000
122222300000000000000000000000200000000000000000000000000000
111111100000000000000000000000000000000000000000000000000000
111111122300000000000000000000200000000000000000000000000000
111111111122222222222222222222122222222222222222222222222222
111111111111111111111111111111111111111111111111111111111111
